3333333333.....3333333333
2.......................3
2.......................3
2.......................3
2.......................3
2.......................3
2.......................3
........................3
........................3
........................3
........................3
2.......................3
2.......................3
2.......................3
2.......................3
2.......................3
2.......................3
2.......................3
3333333333333333333333333