1111111...........1111111
2.......................2
2.......................2
2.......................2
2.......................2
2.......................2
2.......................2
.........................
.........................
.........................
.........................
.........................
2.......................2
2.......................2
2.......................2
2.......................2
2.......................2
2.......................2
11111...............11111