11111...............11111
1.......................1
1.......................1
1.......................1
1.......................1
1.......................1
1.......................1
1........................
1........................
1........................
1........................
1........................
1.......................1
1.......................1
1.......................1
1.......................1
1.......................1
1.......................1
1111111111111111111111111


