2222222222222222222222222
2.......................2
2.......................2
2.......................2
2.......................2
2.......................2
2111111.................2
2....b...................
2....b...................
2....b...................
2....b...................
2....b...................
2111111.................2
2.......................2
2.......................2
2.......................2
2.......................2
2.......................2
2222222222222222222222222