1111111...........1111111
2...rr.............rr...2
2...rrrrrrrrrrrrrrrrr...2
2....rrrrrrrrrrrrrrr....2
2.......................2
2.......................2
2.......................2
.........................
.........................
.........................
.........................
.........................
2.......................2
2.......................2
2.......................2
2.......................2
2.......................2
2.......................2
11111...............11111