3333333333333333333333333
3.......................3
3.......................3
3.......................3
3.......................3
3.......................3
3.......................3
3.......................3
3.......................3
3.......................3
3.......................3
3.......................3
3.......................3
3.......................3
3.......................3
3.......................3
3.......................3
3.......................3
33333333333333....3333333