2222222222222222222222222
2.......................2
2.......................2
2.......................2
2.......................2
211111111..............,2
2.......1...............2
........1................
........1................
........1................
........1................
........1................
2.......1...............2
211111111...............2
2.......................2
2.......................2
2.......................2
2.......................2
2222222222222222222222222