3333333333.....3333333333
2.......................3
2.......................3
2.......................3
2ooo....................3
2oooo...................3
2..oo...................3
...oo...................3
...oo...................3
...oo...................3
...oo...................3
2..oo...................3
2oooo...................3
2ooo....................3
2.......................3
2.......................3
2.......................3
2.......................3
3333333333333333333333333