3333333333333333333333333
3.......................3
3.......................3
3....s....s...s...s.1...3
3...................1...3
3...................1...3
3...................1....
3...................1....
3...11..111...111..11...3
3.......................3
3.......................3
........................3
........................3
3.......................3
3...11..111...111..11...3
3.......................3
3.......e......e........3
3.......................3
3333333333333333333333333