11111...............11111
1.......................1
1.......................1
1.......................1
1.......................1
1.......................1
1.......................1
1........................
1........................
1........................
1........................
1........................
1.......................1
1.......................1
1.......................1
1......yyyyyyyyyyy......1
1.....yyyyyyyyyyyyy.....1
1.....yy.........yy.....1
111111111.......111111111