33333333332....2333333333
3.......................3
3.......................3
3.......................3
3.......................3
3.......................3
3.......................3
3........................
3........................
3........................
3........................
3.......................3
3.......................3
3.......................3
3.......................3
3.......................3
3.......................3
3.......................3
33333333332....2333333333