33333......33333333333333
3...1......1.....333....3
3...1......1..E.........3
3...1..11..1..11.....1..3
3...1..11..1..11111111..3
3...1..11...E..1..1..1..3
3.......1......1..1..1..3
311111111..11111..1..1..3
3.1.....1..1.......E....3
3.1..E..1..1..E.........3
3.1..1111111....1111.1..3
3.1..1..........1..1.1...
3.1..111..1111111..111...
3.1...........1.........3
3.1......E....1.........3
311..1111111111..11111..3
3.......1....1...1......3
3.......1....1.....E....3
33....3333333333333333333