3333333333333333333333333
3.......1.......1.......3
3.......1.......1.......3
3.......1.......1.......3
3.......111...111.......3
3.......................3
3.......................3
3.......................3
3.......................3
3.......................3
3.......................3
3.......................3
3.......................3
3.......................3
3.......................3
3.......................3
3.......................3
3.......................3
33333333332....2333333333