3333333333333333333333333
3.......................3
3.......................3
3.......................3
3...11..111...111..11...3
3.......................3
3........................
3........................
3.......................3
3.......................3
3.......................3
........................3
........................3
3.......................3
3...11..111...111..11...3
3.......................3
3.......................3
3.......................3
3333333333333333333333333