33....3333333333333....33
3.......................3
3.......................3
3.......................3
3.......................3
3.......................3
3.......................3
3.......................3
3.......................3
3.......................3
3.......................3
3.......................3
3.......................3
3...22....22222....22...3
3...2...............2....
3...2...............2....
3...2...............2....
3...2...............2...3
11111...............11111